0,-100,-250,1,1,10,22,19,1
1,300,-150,1,1,10,30,21,1
2,50,100,1,1,10,25,26,1
3,-450,-250,1,1,10,15,19,1
4,-400,-100,1,1,10,16,22,2
5,-300,0,1,1,10,18,24,2
6,-150,0,1,1,10,21,24,2
7,150,-50,1,1,10,27,23,2
8,-100,100,1,1,10,22,26,2
9,300,200,1,1,10,30,28,2
