0,-50,300,1,1,10,23,30,3
1,400,-50,1,1,10,32,23,3
2,-450,-150,1,1,10,15,21,3
3,-150,200,1,1,10,21,28,0
4,-100,-200,1,1,10,22,20,0
5,-250,-200,1,1,10,19,20,2
6,200,-300,1,1,10,28,18,2
7,400,-300,1,1,10,32,18,2
8,250,50,1,1,10,29,25,2
9,50,-150,1,1,10,25,21,2
10,-200,-350,1,1,10,20,17,2
11,200,150,1,1,10,28,27,2
12,150,0,1,1,10,27,24,2
